111111111
100000011
100000011
100000011
111111111