111111111
100000011
111111111
111111111
111111111
111111111